тА╛	с▒Ъс▒╡с▒╖с▒Яс▒и с▒Юс▒Яс▒╣с▒нс▒дс▒▒
тА╜	с▒дс▒▒с▒┤с▒Яс▒ис▒Ъс▒╡с▒ос▒Эс▒Ьс▒╜
тА╕	с▒ас▒ос▒ис▒ос▒┤
тБВ	с▒Яс▒ес▒┤с▒Яс▒ис▒дс▒бс▒╜с▒в
ЁЯША	с▒Юс▒Яс▒▒с▒лс▒Я, с▒Юс▒Яс▒▒с▒лс▒Я с▒кс▒ос▒жс▒ис▒Я, с▒вс▒Ъс▒▓с▒Я, с▒дс▒ес▒дс▒▓
ЁЯШГ	с▒вс▒Яс▒ис▒Яс▒Э с▒вс▒ос▒л с▒ес▒Яс▒Юс▒Яс▒Ь с▒вс▒йс▒Юс▒йс▒б с▒Юс▒Яс▒▒с▒лс▒Я
ЁЯШД	с▒вс▒Ъс▒▓с▒Я с▒дс▒ес▒дс▒▓ с▒ас▒Яс▒л с▒Ыс▒о с▒Юс▒Яс▒▒с▒лс▒Яс▒ос▒л с▒Юс▒ос▒ас▒╖с▒Я с▒вс▒ос▒л
ЁЯШБ	с▒дс▒ес▒дс▒▓ с▒вс▒Ъс▒кс▒Я
ЁЯШЖ	с▒Юс▒Яс▒▒с▒лс▒Я с▒вс▒Ъс▒кс▒Я
ЁЯШЕ	с▒йс▒лс▒╜с▒Ьс▒Яс▒╣с▒и с▒ес▒Яс▒╢с▒Ыс▒о с▒░с▒Яс▒┤с▒Я с▒дс▒ес▒дс▒▓ с▒вс▒Ъс▒▓с▒Я
ЁЯдг	с▒Юс▒Яс▒▒с▒лс▒Я с▒Ьс▒йс▒▓с▒лс▒Яс▒╣с▒г
ЁЯШВ	с▒вс▒Ъс▒бс▒╜ с▒вс▒Ъс▒▓с▒Я
ЁЯЩВ	с▒▒с▒Яс▒ес▒о с▒Юс▒Яс▒▒с▒лс▒Яс▒ос▒л с▒Юс▒ос▒ас▒╖с▒Я с▒кс▒ос▒жс▒ис▒Я
ЁЯЩГ	с▒йс▒Юс▒┤с▒Яс▒╣ с▒кс▒ос▒жс▒ис▒Я
ЁЯла	с▒Ыс▒Ъс▒ис▒▓с▒Яс▒г с▒вс▒Ъс▒▓с▒Я
ЁЯШЙ	с▒╡с▒дс▒▒с▒░с▒йс▒б с▒вс▒Ъс▒▓с▒Я
ЁЯШК	с▒Юс▒Яс▒╕с▒лс▒Я с▒вс▒Ъс▒▓с▒Я с▒ес▒Яс▒╢ с▒Юс▒Яс▒╕с▒лс▒Я с▒вс▒ос▒л
ЁЯШЗ	с▒жс▒Яс▒Юс▒Ъ с▒ес▒Яс▒╢с▒Ыс▒о с▒Юс▒Яс▒▒с▒лс▒Яс▒ос▒л с▒вс▒Ъс▒▓с▒Я
ЁЯе░	с▒лс▒йс▒Юс▒Яс▒╣с▒▓ с▒Юс▒Яс▒▒с▒лс▒Я
ЁЯШН	с▒Юс▒Яс▒▒с▒лс▒Я с▒вс▒Ъс▒▓с▒Я с▒ес▒Яс▒╢с▒Ыс▒о с▒лс▒йс▒Юс▒Яс▒╣с▒▓ с▒вс▒ос▒л
ЁЯдй	с▒дс▒пс▒дс▒Ю с▒вс▒Ъс▒▓с▒Я
ЁЯШШ	с▒кс▒Ъс▒Ьс▒ос▒л с▒вс▒Ъс▒▓с▒Я
ЁЯШЧ	с▒кс▒Ъс▒Ь с▒вс▒Ъс▒▓с▒Я
тШ║я╕П	с▒Юс▒Яс▒▒с▒лс▒Яс▒ос▒л с▒вс▒Ъс▒▓с▒Я
ЁЯШЪ	с▒вс▒ос▒л с▒╡с▒Ъс▒╕с▒л с▒ас▒Яс▒Ыс▒о с▒кс▒Ъс▒Ь
ЁЯШЩ	с▒кс▒Ъс▒Ь с▒вс▒Ъс▒▓с▒Я с▒ас▒Яс▒▒с▒Я
ЁЯе▓	с▒вс▒ос▒л с▒лс▒Яс▒Ь с▒бс▒Ъс▒ис▒Ъ с▒вс▒Ъс▒▓с▒Я
ЁЯШЛ	с▒вс▒Ъс▒бс▒╜ с▒бс▒Ъс▒в
ЁЯШЫ	с▒вс▒Ъс▒▓с▒Я с▒ес▒Яс▒Юс▒Яс▒Ь с▒Яс▒Юс▒Яс▒Э
ЁЯШЬ	с▒Яс▒Юс▒Яс▒Э с▒ес▒Яс▒Юс▒Яс▒Ь с▒вс▒Ъс▒▓с▒Я с▒╡с▒дс▒▒с▒░с▒йс▒б
ЁЯдк	с▒пс▒Яс▒Ьс▒╜с▒Юс▒Я с▒вс▒Ъс▒▓с▒Я
ЁЯШЭ	с▒Яс▒Юс▒Яс▒Э с▒Яс▒и с▒╡с▒Яс▒▒с▒┤с▒╖с▒дс▒а
ЁЯдС	с▒пс▒йс▒нс▒ес▒Яс▒╣ с▒вс▒Ъс▒кс▒Я с▒вс▒Ъс▒▓с▒Я
ЁЯдЧ	с▒ас▒╖с▒йс▒Юс▒Яс▒╣с▒Ыс▒д с▒Ыс▒о с▒Юс▒Яс▒▒с▒лс▒Яс▒ос▒л с▒вс▒Ъс▒▓с▒Я
ЁЯдн	с▒вс▒Ъс▒кс▒Я с▒ис▒о с▒Ыс▒д с▒лс▒Ъс▒жс▒Ъ
ЁЯлв	с▒вс▒йс▒╕ с▒ис▒о с▒Ыс▒д с▒лс▒Ъс▒жс▒Ъ с▒Яс▒и с▒ас▒╖с▒йс▒Юс▒Яс▒╣ с▒вс▒ос▒л с▒Юс▒ос▒ас▒╖с▒Я
ЁЯлг	с▒вс▒ос▒л с▒Ыс▒о с▒йс▒нс▒йс▒Эс▒ос▒л с▒вс▒Ъс▒▓с▒Я
ЁЯдл	с▒кс▒йс▒п с▒вс▒Ъс▒▓с▒Я
ЁЯдФ	с▒╡с▒дс▒кс▒Яс▒╣с▒и с▒вс▒Ъс▒▓с▒Я
ЁЯлб	с▒ес▒ос▒Юс▒нс▒йс▒┤ с▒вс▒Ъс▒▓с▒Я
ЁЯдР	с▒вс▒Ъс▒▓с▒Я с▒бс▒дс▒п
ЁЯди	с▒вс▒Ъс▒▓с▒Я с▒ис▒о с▒вс▒ос▒л с▒ас▒йс▒┤с▒д с▒йс▒╡ с▒Ыс▒йс▒Ю с▒ас▒Яс▒▒с▒Я
ЁЯШРя╕П	с▒Ыс▒Яс▒Юс▒Яс▒вс▒Яс▒Юс▒д с▒вс▒Ъс▒▓с▒Я
ЁЯШС	с▒ес▒йс▒▒ с▒Юс▒Яс▒╣с▒нс▒пс▒Яс▒ес▒▒с▒Яс▒г с▒вс▒Ъс▒▓с▒Я
ЁЯШ╢	с▒╡с▒дс▒▒ с▒вс▒Ъс▒кс▒Я с▒вс▒Ъс▒▓с▒Я
ЁЯле	с▒░с▒Ъс▒┤ с▒Юс▒Яс▒нс▒дс▒▒ с▒вс▒Ъс▒▓с▒Я
ЁЯШ╢тАНЁЯМл	с▒вс▒Ъс▒▓с▒Я с▒ис▒о с▒ис▒дс▒вс▒дс▒Ю
ЁЯШП	с▒Юс▒Яс▒▒с▒лс▒Я с▒вс▒Ъс▒▓с▒Я
ЁЯШТ	с▒╡с▒ос▒ас▒╖с▒Яс▒Ыс▒дс▒и с▒вс▒Ъс▒▓с▒Я
ЁЯЩД	с▒Ьс▒йс▒░с▒ис▒Яс▒╣с▒г с▒вс▒ос▒л с▒ас▒йс▒┤с▒д с▒вс▒Ъс▒▓с▒Я
ЁЯШм	с▒дс▒ес▒дс▒▓ с▒вс▒Ъс▒▓с▒Я
ЁЯШотАНЁЯТи	с▒жс▒Яс▒гс▒Я с▒Ъс▒░с▒Ъс▒а с▒вс▒Ъс▒▓с▒Я
ЁЯде	с▒ос▒▓с▒о с▒вс▒Ъс▒▓с▒Я
ЁЯли	с▒ис▒йс▒ас▒й с▒вс▒Ъс▒▓с▒Я
ЁЯШМ	с▒Ъс▒кс▒дс▒▒с▒Ыс▒Яс▒╣ с▒вс▒Ъс▒▓с▒Я
ЁЯШФ	с▒кс▒дс▒▒с▒Ыс▒Яс▒╣ с▒вс▒Ъс▒▓с▒Я
ЁЯШк	с▒бс▒Яс▒╣с▒пс▒дс▒л с▒вс▒Ъс▒▓с▒Я
ЁЯдд	с▒йс▒Юс▒д с▒лс▒Яс▒Ь с▒вс▒Ъс▒▓с▒Я
ЁЯШ┤	с▒Ьс▒дс▒Ыс▒дс▒б с▒вс▒Ъс▒▓с▒Я
ЁЯШ╖	с▒вс▒ос▒░с▒дс▒ас▒Яс▒Ю с▒вс▒Яс▒ес▒а с▒вс▒Ъс▒▓с▒Я
ЁЯдТ	с▒вс▒Ъс▒▓с▒Я с▒ес▒Яс▒Юс▒Яс▒Ь с▒Ыс▒╖с▒Ъс▒ис▒вс▒Ъс▒вс▒дс▒┤с▒Ъс▒и
ЁЯдХ	с▒╡с▒ос▒▒с▒░с▒ос▒б с▒ес▒Яс▒Юс▒Яс▒Ь с▒Ыс▒о с▒вс▒Ъс▒▓с▒Я
ЁЯдв	с▒йс▒Юс▒Яс▒╣ с▒вс▒Ъс▒▓с▒Я
ЁЯдо	с▒йс▒Юс▒Яс▒╣с▒ос▒л с▒вс▒Ъс▒▓с▒Я
ЁЯдз	с▒кс▒╖с▒йс▒и с▒вс▒Ъс▒▓с▒Я
ЁЯе╡	с▒Ьс▒Ъс▒ис▒Ъс▒в с▒вс▒Ъс▒▓с▒Я
ЁЯе╢	с▒ис▒Яс▒╡с▒Яс▒Э с▒вс▒Ъс▒▓с▒Я
ЁЯе┤	с▒Яс▒╣с▒░с▒д с▒вс▒Ъс▒бс▒╜ с▒вс▒Ъс▒▓с▒Я
ЁЯШ╡	с▒Ыс▒дс▒ис▒кс▒╖с▒Яс▒╣ с▒вс▒Ъс▒▓с▒Я
ЁЯШ╡тАНЁЯТл	с▒Ьс▒╖с▒йс▒ис▒Яс▒╣с▒г с▒вс▒ос▒л с▒вс▒Ъс▒▓с▒Я
ЁЯдп	с▒╡с▒Ъс▒жс▒Ъс▒Ь с▒Ъс▒┤с▒Ъс▒бс▒Ъс▒Ь
ЁЯда	с▒░с▒Яс▒╣с▒Эс▒Ьс▒╜с▒ис▒д с▒Ьс▒йс▒пс▒д с▒Ьс▒дс▒лс▒╜с▒ис▒Яс▒╣ с▒┤с▒йс▒пс▒д
ЁЯе│	с▒ес▒Ъс▒▓с▒о с▒вс▒Ъс▒▓с▒Я
ЁЯе╕	с▒вс▒Ъс▒▓с▒Я
ЁЯдб	с▒бс▒Ъс▒ас▒Ъс▒и с▒вс▒Ъс▒▓с▒Я
ЁЯС╗	с▒╡с▒╖с▒йс▒Ы
ЁЯШ║	с▒пс▒йс▒ес▒д с▒дс▒ес▒дс▒▓ с▒ас▒Яс▒лс▒Яс▒н
ЁЯТМ	с▒лс▒йс▒Юс▒Яс▒╣с▒▓с▒дс▒нс▒Яс▒╣ с▒кс▒дс▒┤с▒╖с▒д
ЁЯТХ	с▒╡с▒Яс▒ис▒нс▒Я с▒ис▒дс▒лс▒Яс▒╣с▒н
ЁЯТЛ	с▒кс▒Ъс▒Ь с▒кс▒дс▒▒с▒жс▒Яс▒╣
ЁЯТп	с▒ес▒Яс▒н с▒пс▒Ъс▒ос▒▒с▒┤с▒е
ЁЯТв	с▒ис▒Яс▒╣с▒Ьс▒д с▒кс▒дс▒▒с▒жс▒Яс▒╣
ЁЯТе	с▒Ъс▒┤с▒ос▒б
ЁЯТж	с▒йс▒лс▒╜с▒Ьс▒Яс▒╣с▒и с▒бс▒Ъс▒ис▒Ъ
ЁЯХ│я╕П	с▒╡с▒╖с▒йс▒Ьс▒Яс▒╣с▒Ь
ЁЯТм	с▒ис▒Ъс▒▓ с▒╡с▒ос▒Юс▒йс▒▒
ЁЯСБтАНЁЯЧи	с▒ис▒ос▒▓ с▒вс▒ос▒л с▒ис▒дс▒вс▒дс▒Ю
ЁЯЧия╕П	с▒Юс▒ос▒Эс▒Ьс▒Я с▒ис▒Ъс▒▓ с▒ис▒дс▒вс▒дс▒Ю
ЁЯЧпя╕П	с▒бс▒Ъс▒бс▒Ъс▒в с▒ис▒Яс▒╣с▒Ьс▒д с▒ис▒дс▒вс▒дс▒Ю
ЁЯТн	с▒йс▒нс▒жс▒Яс▒╣с▒и с▒пс▒╖с▒йс▒ас▒Яс▒╣
ЁЯТд	с▒бс▒Яс▒╣с▒пс▒дс▒л
ЁЯСЛ	с▒Ыс▒д, с▒Ыс▒д с▒жс▒йс▒ис▒Юс▒Яс▒╣, с▒жс▒йс▒ис▒Юс▒Я.
ЁЯдЪ	с▒Ыс▒д с▒Ыс▒йс▒Ю с▒ис▒Яс▒ас▒Яс▒╡
ЁЯЦРя╕П	с▒Ыс▒д с▒ас▒Яс▒╣с▒┤с▒йс▒╡ с▒ас▒Ъ с▒пс▒Яс▒ес▒▒с▒Яс▒г с▒ас▒Яс▒▒с▒Я
тЬЛя╕П	с▒Ыс▒д с▒Ыс▒йс▒Ю
ЁЯЦЦ	с▒Ыс▒д с▒ес▒ос▒Юс▒нс▒йс▒┤
ЁЯл▒	с▒бс▒Ъс▒бс▒Ъс▒в с▒Ыс▒д
ЁЯл▓	с▒Юс▒ос▒Эс▒Ьс▒Я с▒Ыс▒д
ЁЯл│	с▒Ыс▒д с▒Ыс▒Яс▒Юс▒ас▒╖с▒Я с▒Юс▒Яс▒Ыс▒Яс▒и
ЁЯл┤	с▒Ыс▒д с▒Ыс▒Яс▒Юс▒ас▒╖с▒Я с▒кс▒ос▒Ыс▒Яс▒▒
ЁЯСМ	с▒Ыс▒д с▒Ыс▒о с▒Ьс▒йс▒Юс▒Яс▒╣с▒н
ЁЯЦХ	с▒Ыс▒Яс▒Юс▒Я с▒ас▒Яс▒╣с▒┤с▒йс▒╡
ЁЯСЗя╕П	с▒Юс▒Яс▒Ыс▒Яс▒и с▒ес▒ос▒л с▒йс▒лс▒йс▒Ь
тШЭя╕П	с▒кс▒ос▒Ыс▒Яс▒▒ с▒ес▒ос▒л с▒йс▒лс▒йс▒Ь
ЁЯл╡	с▒жс▒Ъс▒▓ с▒ес▒ос▒▒ с▒йс▒лс▒йс▒Ь
ЁЯСНя╕П	с▒ос▒Эс▒Ьс▒Я с▒ас▒Яс▒╣с▒┤с▒йс▒╡ с▒лс▒ос▒ас▒╖с▒Яс▒г
ЁЯСОя╕П	с▒ос▒Эс▒Ьс▒Я с▒ас▒Яс▒╣с▒┤с▒йс▒╡ с▒йс▒Юс▒┤с▒Яс▒╣
тЬКя╕П	с▒вс▒йс▒┤с▒╖с▒Яс▒╣ с▒Ыс▒йс▒Ю с▒ас▒Яс▒▒с▒Я
ЁЯСК	с▒жс▒Яс▒╣с▒бс▒йс▒Ь с▒ас▒Яс▒▒ с▒вс▒йс▒┤с▒╖с▒Яс▒╣
ЁЯдЫ	с▒Юс▒ос▒Эс▒Ьс▒Я с▒вс▒йс▒жс▒Яс▒╣ с▒вс▒йс▒┤с▒╖с▒Яс▒╣
ЁЯдЬ	с▒бс▒Ъс▒бс▒Ъс▒в с▒вс▒йс▒жс▒Яс▒╣ с▒вс▒йс▒┤с▒╖с▒Яс▒╣
ЁЯСП	с▒Ыс▒╖с▒Яс▒нс▒Ъ с▒Ыс▒д
ЁЯЩМ	с▒Ыс▒йс▒Ю с▒Ыс▒д
ЁЯл╢	с▒лс▒йс▒Юс▒Яс▒╣с▒▓ с▒Ыс▒д
ЁЯСР	с▒ас▒╖с▒йс▒Юс▒Яс▒╣ с▒Ыс▒д
ЁЯд▓	с▒ес▒Яс▒╢с▒Ыс▒о с▒Ыс▒д с▒Ыс▒Яс▒Юс▒ас▒╖с▒Я
ЁЯдЭ	с▒Ыс▒д с▒вс▒ос▒▓с▒Яс▒г
ЁЯЩП	с▒бс▒Ъс▒жс▒Яс▒и
тЬНя╕П	с▒Ъс▒Ю с▒Ыс▒д
ЁЯТЕ	с▒ис▒Яс▒вс▒Я с▒бс▒Ъс▒Ыс▒Ъс▒▒
ЁЯд│	с▒ес▒ос▒Юс▒пс▒╖с▒д
ЁЯСВя╕П	с▒Юс▒йс▒Ыс▒йс▒и
ЁЯж╖	с▒░с▒Яс▒┤с▒Я
ЁЯж┤	с▒бс▒Яс▒Э
ЁЯСА	с▒вс▒ос▒л
ЁЯС╢	с▒Ьс▒дс▒лс▒╜с▒ис▒Я
ЁЯзТ	с▒Ьс▒дс▒лс▒╜с▒ис▒Яс▒╣
ЁЯСж	с▒ас▒Ъс▒▓с▒Я
ЁЯСз	с▒ас▒йс▒▓с▒д
ЁЯзС	с▒жс▒Ъс▒▓ с▒Ьс▒о
ЁЯзСтАНЁЯж░	с▒Яс▒ис▒Яс▒Ь с▒йс▒╡, с▒жс▒Ъс▒▓ с▒Ьс▒о, с▒жс▒Ъс▒▓ с▒Ьс▒о: с▒Яс▒ис▒Яс▒Ь с▒йс▒╡
ЁЯзСтАНЁЯж│	с▒жс▒Ъс▒▓ с▒Ьс▒о, с▒жс▒Ъс▒▓ с▒Ьс▒о: с▒пс▒йс▒╕с▒▒с▒░ с▒йс▒╡, с▒пс▒йс▒╕с▒▒с▒░ с▒йс▒╡
ЁЯСи	с▒жс▒Ъс▒▓
ЁЯзФтАНтЩВ	с▒жс▒Ъс▒▓с▒Яс▒Ь с▒░с▒Яс▒╣с▒░с▒жс▒д
ЁЯСитАНЁЯж░	с▒Яс▒ис▒Яс▒Ь с▒йс▒╡, с▒жс▒Ъс▒▓, с▒жс▒Ъс▒▓: с▒Яс▒ис▒Яс▒Ь с▒йс▒╡
ЁЯСитАНЁЯж│	с▒жс▒Ъс▒▓, с▒жс▒Ъс▒▓: с▒пс▒йс▒╕с▒▒с▒░ с▒йс▒╡, с▒пс▒йс▒╕с▒▒с▒░ с▒йс▒╡
ЁЯСй	с▒вс▒Яс▒╣с▒нс▒бс▒й
ЁЯзФтАНтЩА	с▒вс▒Яс▒╣с▒нс▒бс▒й с▒лс▒Яс▒╣с▒░с▒жс▒д
ЁЯСйтАНЁЯж░	с▒Яс▒ис▒Яс▒Ь с▒йс▒╡, с▒вс▒Яс▒╣с▒нс▒бс▒й, с▒вс▒Яс▒╣с▒нс▒бс▒й: с▒Яс▒ис▒Яс▒Ь с▒йс▒╡
ЁЯСйтАНЁЯж│	с▒вс▒Яс▒╣с▒нс▒бс▒й, с▒вс▒Яс▒╣с▒нс▒бс▒й: с▒пс▒йс▒╕с▒▒с▒░ с▒йс▒╡, с▒пс▒йс▒╕с▒▒с▒░ с▒йс▒╡
ЁЯзУ	с▒жс▒Яс▒▓с▒Яс▒в с▒жс▒Ъс▒▓ с▒Ьс▒о
ЁЯС┤	с▒вс▒Яс▒▓с▒Яс▒в с▒жс▒Ъс▒▓
ЁЯС╡	с▒╡с▒йс▒░с▒╖с▒д
ЁЯзПтАНтЩВ	с▒ас▒Яс▒Юс▒Я с▒жс▒Ъс▒▓
ЁЯд╜тАНтЩВ	с▒жс▒Ъс▒▓
ЁЯж░	с▒Яс▒ис▒Яс▒Ь с▒йс▒╡
ЁЯж│	с▒пс▒йс▒╕с▒▒с▒░ с▒йс▒╡
ЁЯР╡	с▒жс▒Яс▒╣с▒мс▒й с▒вс▒Ъс▒▓с▒Я
ЁЯРТ	с▒жс▒Яс▒╣с▒мс▒й
ЁЯжН	с▒Ьс▒Ъс▒ис▒дс▒Юс▒Я
ЁЯжз	с▒Ъс▒ис▒Яс▒Эс▒Ьс▒йс▒┤с▒Яс▒▒
ЁЯР╢	с▒ес▒ос▒Ыс▒Я с▒вс▒Ъс▒▓с▒Я
ЁЯРХя╕П	с▒ес▒ос▒Ыс▒Я
ЁЯжо	с▒Ьс▒Ъс▒▓с▒Ъ с▒ес▒ос▒Ыс▒Я
ЁЯРХтАНЁЯж║	с▒ас▒Яс▒╣с▒вс▒д с▒ес▒ос▒Ыс▒Я
ЁЯРй	с▒Юс▒Ъс▒вс▒Ъс▒е с▒ес▒ос▒Ыс▒Я
ЁЯР║	с▒жс▒Яс▒░с▒Ьс▒Яс▒и
ЁЯжК	с▒Ыс▒йс▒нс▒й
ЁЯР▒	с▒пс▒йс▒ес▒д с▒вс▒Ъс▒▓с▒Я
ЁЯРИя╕П	с▒пс▒йс▒ес▒д
ЁЯРИтАНтмЫ	с▒жс▒ос▒▒с▒лс▒о с▒пс▒йс▒ес▒д
ЁЯжБ	с▒ас▒йс▒Ю
ЁЯРп	с▒Ыс▒Яс▒╣с▒ис▒йс▒╡ с▒вс▒Ъс▒▓с▒Я
ЁЯРЕ	с▒Ыс▒Яс▒╣с▒ис▒йс▒╡
ЁЯРЖ	с▒кс▒ос▒┤с▒ис▒Я
ЁЯР┤	с▒ес▒Яс▒лс▒Ъс▒в с▒вс▒Ъс▒▓с▒Я
ЁЯлП	с▒Ьс▒Яс▒лс▒╖с▒Я
ЁЯРО	с▒ес▒Яс▒лс▒Ъс▒в
ЁЯжМ	с▒ес▒ос▒Юс▒ос▒╡
ЁЯРо	с▒░с▒Яс▒╣с▒Эс▒Ьс▒╜с▒ис▒д с▒вс▒Ъс▒▓с▒Я
ЁЯРГ	с▒лс▒Яс▒Ь с▒ас▒Яс▒▓с▒Я
ЁЯРД	с▒░с▒Яс▒╣с▒Эс▒Ьс▒╜с▒ис▒д
ЁЯР╖	с▒ес▒йс▒ас▒ис▒д с▒вс▒Ъс▒▓с▒Я
ЁЯРЦ	с▒ес▒йс▒ас▒ис▒д
ЁЯРР	с▒вс▒ос▒ис▒Ъс▒в
ЁЯРк	с▒йс▒▒с▒┤с▒╖
ЁЯРШ	с▒жс▒Яс▒╣с▒Ыс▒д
ЁЯРБ	с▒Ьс▒йс▒░с▒й
ЁЯРА	с▒кс▒йс▒▒с▒л
ЁЯР╣	с▒вс▒Яс▒▓с▒Я
ЁЯР░	с▒ас▒йс▒Юс▒Яс▒╣с▒н с▒вс▒Ъс▒▓с▒Я
ЁЯРЗ	с▒ас▒йс▒Юс▒Яс▒╣с▒н
ЁЯжЗ	с▒╡с▒Яс▒╣с▒ис▒лс▒йс▒мс▒дс▒б
ЁЯР╗	с▒╡с▒Яс▒▒с▒Я
ЁЯРи	с▒вс▒Ъс▒▓с▒Я
ЁЯРФ	с▒ес▒дс▒в
ЁЯРд	с▒Ьс▒дс▒лс▒╜с▒ис▒Яс▒╣ с▒ес▒дс▒в
ЁЯРе	с▒ес▒дс▒лс▒╖с▒Яс▒╣ с▒ес▒Яс▒вс▒Яс▒Эс▒ос▒л с▒Ьс▒дс▒лс▒╜с▒ис▒Яс▒╣ с▒ес▒дс▒в
ЁЯРжя╕П	с▒кс▒ос▒мс▒ос▒╕
ЁЯжЙ	с▒ас▒Ъс▒ас▒Ъс▒и
ЁЯк╢	с▒дс▒Ю
ЁЯжЬ	с▒вс▒дс▒ис▒й
ЁЯк╜	с▒пс▒╖с▒Яс▒╣с▒ас▒мс▒Яс▒╣с▒Ь
ЁЯРжтАНтмЫ	с▒жс▒ос▒▒с▒лс▒о с▒кс▒ос▒мс▒о
ЁЯР╕	с▒ис▒ос▒┤с▒Ъ
ЁЯРв	с▒жс▒Ъс▒ис▒Ъ
ЁЯжО	с▒кс▒ос▒ис▒кс▒ос▒┤с▒ос▒б
ЁЯРН	с▒╡с▒дс▒Э
ЁЯР▓	с▒вс▒Ъс▒▓с▒Я
ЁЯР│	с▒вс▒Ъс▒▓с▒Я, с▒жс▒Яс▒╣с▒ас▒й
ЁЯРЯя╕П	с▒жс▒Яс▒╣с▒ас▒й
ЁЯРа	с▒жс▒Яс▒╣с▒ас▒й
ЁЯРб	с▒жс▒Яс▒╣с▒ас▒й
ЁЯжИ	с▒жс▒Яс▒╣с▒ас▒й
ЁЯРЩ	с▒дс▒ис▒Яс▒╣с▒Ю с▒ас▒Яс▒┤с▒Я с▒жс▒Яс▒╣с▒ас▒й
ЁЯРЪ	с▒ис▒Ъс▒ас▒Ъс▒б с▒кс▒╖с▒дс▒Юс▒ас▒Яс▒╣
ЁЯРМ	с▒ис▒Ъс▒ас▒Ъс▒б
ЁЯжЛ	с▒пс▒дс▒пс▒дс▒▓с▒дс▒нс▒Яс▒╣
ЁЯРЫ	с▒йс▒ис▒й
ЁЯРЬ	с▒вс▒йс▒б
ЁЯРЭ	с▒ес▒йс▒ес▒йс▒ис▒╡с▒Яс▒Э
ЁЯХ╖я╕П	с▒╡с▒дс▒▒с▒лс▒д
ЁЯХ╕я╕П	с▒╡с▒дс▒▒с▒лс▒д с▒бс▒Яс▒╣с▒Юс▒д
ЁЯжЯ	с▒ес▒дс▒ас▒мс▒дс▒б
ЁЯк▒	с▒Ыс▒дс▒бс▒й
ЁЯТР	с▒╡с▒Яс▒жс▒Я с▒Ьс▒йс▒кс▒╖с▒Яс▒╣
ЁЯМ╕	с▒кс▒ос▒ис▒н с▒ас▒╖с▒дс▒Юс▒Яс▒╣с▒г
ЁЯТо	с▒пс▒йс▒╕с▒░ с▒╡с▒Яс▒жс▒Я
ЁЯк╖	с▒пс▒Ъс▒ис▒Яс▒нс▒▒с▒д
ЁЯМ╣	с▒Ьс▒йс▒Юс▒Яс▒╣с▒п
ЁЯМ▒	с▒Ьс▒Ъс▒бс▒Я
ЁЯНД	с▒йс▒л
ЁЯНЗ	с▒Ъс▒Эс▒Ьс▒йс▒и
ЁЯНИ	с▒Ыс▒Яс▒╣с▒ис▒╡с▒йс▒б
ЁЯНЙ	с▒лс▒Яс▒Ь с▒Ыс▒Яс▒╣с▒ис▒╡с▒йс▒б
ЁЯНК	с▒бс▒Яс▒╣с▒вс▒╡с▒дс▒и
ЁЯНЛ	с▒Юс▒ос▒вс▒╡с▒й
ЁЯНМ	с▒ас▒Яс▒нс▒ис▒Я
ЁЯНН	с▒Ъс▒▒с▒Яс▒и
ЁЯен	с▒йс▒Ю
ЁЯНО	с▒Яс▒ис▒Яс▒Ь с▒ес▒ос▒г
ЁЯНП	с▒жс▒Яс▒╣с▒ис▒дс▒нс▒Яс▒╣с▒▓ с▒ес▒ос▒г
ЁЯНР	с▒бс▒Ъ
ЁЯНС	с▒бс▒Ъ
ЁЯНТ	с▒бс▒Ъ
ЁЯНУ	с▒бс▒Ъ
ЁЯеЭ	с▒ас▒дс▒гс▒д с▒бс▒Ъ
ЁЯНЕ	с▒╡с▒дс▒Юс▒Яс▒╣с▒Ы
ЁЯлТ	с▒Ъс▒Юс▒Яс▒нс▒дс▒╡
ЁЯее	с▒▒с▒йс▒▓с▒дс▒нс▒Яс▒╣
ЁЯеС	с▒Яс▒гс▒Ъс▒ас▒Яс▒ис▒░с▒Ъ
ЁЯНЖ	с▒╡с▒ос▒Эс▒Ьс▒Яс▒▓
ЁЯеФ	с▒Яс▒╣с▒▓с▒й
ЁЯеХ	с▒Ьс▒Ъс▒бс▒Ъс▒и
ЁЯМ╢я╕П	с▒вс▒Яс▒╣с▒ис▒дс▒к
ЁЯлС	с▒ес▒дс▒вс▒Юс▒Яс▒╣ с▒вс▒Яс▒╣с▒ис▒дс▒к
ЁЯеТ	с▒Ыс▒Яс▒жс▒ос▒и
ЁЯем	с▒жс▒Яс▒╣с▒ис▒дс▒нс▒Яс▒╣с▒▓ с▒ес▒Яс▒ас▒Яс▒в
ЁЯеж	с▒╡с▒╜с▒ис▒Ъс▒ас▒Ъс▒Юс▒д
ЁЯзД	с▒Юс▒ос▒ес▒йс▒▒
ЁЯзЕ	с▒пс▒ос▒нс▒Яс▒бс▒╜
ЁЯеЬ	с▒╡с▒Яс▒лс▒Яс▒в
ЁЯлШ	с▒вс▒Ъс▒┤с▒Ъс▒и
ЁЯлЪ	с▒Ъс▒лс▒Я с▒ис▒ос▒жс▒ос▒л
ЁЯлЫ	с▒вс▒Ъс▒┤с▒Ъс▒и с▒бс▒Ъ
ЁЯНЮ	с▒пс▒Яс▒╕ с▒ис▒йс▒┤с▒д
ЁЯеР	с▒пс▒Яс▒╕ с▒ис▒йс▒┤с▒д
ЁЯеЦ	с▒бс▒╖с▒Яс▒╣с▒Ю с▒пс▒Яс▒╕ с▒ис▒йс▒┤с▒д
ЁЯлУ	с▒кс▒Ъс▒пс▒┤с▒Я с▒пс▒Яс▒╕ с▒ис▒йс▒┤с▒д
ЁЯеи	с▒пс▒ис▒ос▒┤с▒бс▒Яс▒Ю
ЁЯеп	с▒Ьс▒йс▒Ю с▒Юс▒Яс▒╣с▒░с▒й
ЁЯеЮ	с▒ас▒Ъс▒░с▒╖с▒Я с▒пс▒Яс▒╕ с▒ис▒йс▒┤с▒д
ЁЯНЦ	с▒бс▒Яс▒Э с▒ис▒о с▒бс▒дс▒Ю
ЁЯНЧ	с▒бс▒Яс▒Э с▒бс▒дс▒Ю
ЁЯей	с▒Ьс▒ос▒л с▒ас▒Яс▒▒ с▒бс▒дс▒Ю
ЁЯНХ	с▒пс▒дс▒бс▒Я
ЁЯеЪ	с▒╡с▒дс▒Юс▒д
ЁЯН│	с▒дс▒ес▒дс▒▒
ЁЯеЧ	с▒жс▒Яс▒╣с▒ис▒дс▒нс▒Яс▒╣с▒▓ с▒ес▒Яс▒Юс▒Яс▒░
ЁЯзВ	с▒╡с▒йс▒Юс▒йс▒в
ЁЯНЩ	с▒лс▒Яс▒ас▒Я с▒Ьс▒йс▒Юс▒Яс▒╣с▒н
ЁЯНЪ	с▒дс▒ес▒дс▒▒ с▒ас▒Яс▒▒ с▒кс▒Яс▒гс▒Юс▒о
ЁЯжА	с▒ас▒Яс▒┤с▒ас▒Ъс▒в
ЁЯНи	с▒╡с▒Ъс▒ис▒Ъс▒пс▒╖ с▒кс▒╖с▒Яс▒Юс▒о
ЁЯНк	с▒Юс▒Яс▒╣с▒░с▒й
ЁЯОВ	с▒бс▒Яс▒▒с▒Яс▒в с▒вс▒Яс▒жс▒Яс▒╕ с▒пс▒дс▒┤с▒╖с▒Яс▒╣
ЁЯН░	с▒ас▒╖с▒Яс▒┤с▒Ъ с▒пс▒дс▒┤с▒╖с▒Яс▒╣
ЁЯНм	с▒кс▒Ъс▒ас▒Юс▒ос▒┤
ЁЯеЫ	с▒вс▒дс▒л с▒Ьс▒дс▒Юс▒Яс▒╣с▒е с▒Ыс▒Ъс▒гс▒Я
ЁЯзК	с▒╡с▒Ъс▒ис▒Ъс▒пс▒╖
ЁЯеД	с▒кс▒Яс▒╣с▒вс▒йс▒к
ЁЯФк	с▒лс▒Яс▒ас▒Я с▒Ъс▒▓с▒Яс▒Ь с▒кс▒╖с▒йс▒ис▒д
ЁЯлЩ	с▒бс▒Яс▒и
ЁЯЧ║я╕П	с▒бс▒ос▒Ьс▒ос▒Ы с▒▒с▒Ъс▒ас▒ес▒Я
ЁЯЧ╛	с▒бс▒Яс▒пс▒Яс▒▒ с▒ис▒ос▒нс▒Яс▒Ь с▒▒с▒Ъс▒ас▒ес▒Я
ЁЯПФя╕П	с▒╡с▒Ъс▒ис▒Ъс▒пс▒╖ с▒ас▒Яс▒▒ с▒╡с▒йс▒ис▒й
тЫ░я╕П	с▒╡с▒йс▒ис▒й
ЁЯПЯя╕П	с▒ес▒┤с▒ос▒░с▒дс▒нс▒Ъс▒в
ЁЯз▒	с▒дс▒┤с▒Яс▒╣
ЁЯки	с▒кс▒Яс▒╣с▒┤с▒▒с▒д
ЁЯк╡	с▒ас▒Яс▒┤с▒╖
ЁЯЫЦ	с▒Ъс▒▓с▒Яс▒Ь
ЁЯПШя╕П	с▒Ъс▒▓с▒Яс▒Ь с▒ас▒Ъ
ЁЯПи	с▒жс▒Ъс▒┤с▒ос▒Ю
ЁЯПй	с▒лс▒йс▒Юс▒Яс▒╣с▒▓ с▒жс▒Ъс▒┤с▒ос▒Ю
ЁЯОИ	с▒пс▒╖с▒йс▒ас▒Яс▒╣
ЁЯПП	с▒ас▒ис▒дс▒ас▒ос▒┤ с▒ас▒╖с▒ос▒Ю
ЁЯП╕	с▒╡с▒ос▒░с▒вс▒дс▒▒с▒┤с▒Ъс▒▒
ЁЯСУя╕П	с▒кс▒Ъс▒ес▒вс▒Я
ЁЯХ╢я╕П	с▒жс▒ос▒▒с▒лс▒о с▒кс▒Ъс▒ес▒вс▒Я
ЁЯе╜	с▒вс▒Ъс▒┤с▒Я с▒кс▒ос▒ес▒вс▒Я
ЁЯе╝	с▒Юс▒ос▒п с▒ас▒Ъс▒┤
ЁЯСХ	с▒ес▒Яс▒┤
ЁЯСЦ	с▒бс▒дс▒▒с▒е
ЁЯСЧ	с▒лс▒Ъс▒Ыс▒Ъ
ЁЯе╗	с▒ес▒Яс▒╣с▒░с▒д
ЁЯСЫ	с▒пс▒Ъс▒ис▒е
ЁЯСЬ	с▒Ыс▒дс▒╡с▒ос▒Ьс▒╜
ЁЯСЮ	с▒бс▒йс▒Ыс▒Яс▒╣, с▒жс▒Ъс▒ис▒Ъс▒Ь с▒бс▒дс▒▒с▒дс▒е
ЁЯФФ	с▒Ьс▒╖с▒Ъс▒▒с▒┤с▒д
ЁЯУ▒	с▒вс▒Ъс▒╡с▒Яс▒нс▒дс▒Ю с▒пс▒╖с▒Ъс▒▒
ЁЯФЛ	с▒╡с▒ос▒┤с▒ис▒н
ЁЯкл	с▒ас▒Ъс▒в с▒╡с▒ос▒┤с▒ис▒н
ЁЯТ╗я╕П	с▒Юс▒ос▒пс▒┤с▒Ъс▒п
ЁЯЦея╕П	с▒░с▒ос▒ес▒ас▒┤с▒Ъс▒п с▒ас▒Ъс▒вс▒пс▒йс▒┤с▒Ъс▒и
ЁЯТгя╕П	с▒╡с▒Ъс▒в
ЁЯПз	ATM с▒кс▒дс▒▒с▒жс▒Яс▒╣
ЁЯЪ╝я╕П	с▒Ьс▒дс▒лс▒╜с▒ис▒Яс▒╣ с▒кс▒дс▒▒с▒жс▒Яс▒╣
тЪая╕П	с▒жс▒йс▒ес▒дс▒нс▒Яс▒╣с▒и
тЫФя╕П	с▒╡с▒Ъс▒Юс▒Ъ с▒вс▒Яс▒▒с▒Я с▒Ьс▒ос▒нс▒Я
ЁЯОж	с▒ес▒дс▒▒с▒ос▒вс▒Я
#тГг	с▒ас▒дс▒ас▒ос▒п, с▒ас▒дс▒ас▒ос▒п: #
*тГг	с▒ас▒дс▒ас▒ос▒п, с▒ас▒дс▒ас▒ос▒п: *
0тГг	с▒ас▒дс▒ас▒ос▒п, с▒ас▒дс▒ас▒ос▒п: 0
1тГг	с▒ас▒дс▒ас▒ос▒п, с▒ас▒дс▒ас▒ос▒п: 1
2тГг	с▒ас▒дс▒ас▒ос▒п, с▒ас▒дс▒ас▒ос▒п: 2
3тГг	с▒ас▒дс▒ас▒ос▒п, с▒ас▒дс▒ас▒ос▒п: 3
4тГг	с▒ас▒дс▒ас▒ос▒п, с▒ас▒дс▒ас▒ос▒п: 4
5тГг	с▒ас▒дс▒ас▒ос▒п, с▒ас▒дс▒ас▒ос▒п: 5
6тГг	с▒ас▒дс▒ас▒ос▒п, с▒ас▒дс▒ас▒ос▒п: 6
7тГг	с▒ас▒дс▒ас▒ос▒п, с▒ас▒дс▒ас▒ос▒п: 7
8тГг	с▒ас▒дс▒ас▒ос▒п, с▒ас▒дс▒ас▒ос▒п: 8
9тГг	с▒ас▒дс▒ас▒ос▒п, с▒ас▒дс▒ас▒ос▒п: 9
ЁЯФЯ	с▒ас▒дс▒ас▒ос▒п, с▒ас▒дс▒ас▒ос▒п: 10
ЁЯП┤	с▒жс▒ос▒╕с▒лс▒о с▒кс▒дс▒и
ЁЯП│я╕П	с▒пс▒йс▒╕с▒░ с▒кс▒дс▒и
ЁЯЗжЁЯЗи	с▒кс▒дс▒и, с▒кс▒дс▒и: с▒Яс▒ес▒ос▒▒с▒ес▒дс▒нс▒Яс▒╣с▒▒ с▒Яс▒нс▒Юс▒ос▒╕с▒░
ЁЯЗжЁЯЗй	с▒кс▒дс▒и, с▒кс▒дс▒и: с▒Яс▒▒с▒░с▒Ъс▒ис▒Я
ЁЯЗжЁЯЗк	с▒кс▒дс▒и, с▒кс▒дс▒и: с▒бс▒йс▒вс▒дс▒л с▒Яс▒ис▒Яс▒╣с▒╡ с▒ос▒вс▒дс▒ис▒ос▒┤с▒е
ЁЯЗжЁЯЗл	с▒кс▒дс▒и, с▒кс▒дс▒и: с▒Яс▒пс▒╖с▒Ьс▒Яс▒▒с▒дс▒ес▒Ыс▒Яс▒▒
ЁЯЗжЁЯЗм	с▒кс▒дс▒и, с▒кс▒дс▒и: с▒Яс▒▒с▒┤с▒дс▒Ьс▒йс▒гс▒Я с▒Яс▒и с▒╡с▒Яс▒╣с▒ис▒вс▒йс▒▒с▒░с▒Я
ЁЯЗжЁЯЗо	с▒кс▒дс▒и, с▒кс▒дс▒и: с▒Яс▒╣с▒▒с▒Ьс▒йс▒нс▒Юс▒Я
ЁЯЗжЁЯЗ▒	с▒кс▒дс▒и, с▒кс▒дс▒и: с▒Яс▒Юс▒╡с▒Яс▒▒с▒дс▒нс▒Я
ЁЯЗжЁЯЗ▓	с▒кс▒дс▒и, с▒кс▒дс▒и: с▒Яс▒ис▒вс▒ос▒▒с▒дс▒нс▒Я
ЁЯЗжЁЯЗ┤	с▒кс▒дс▒и, с▒кс▒дс▒и: с▒Яс▒╣с▒▒с▒Ьс▒Ъс▒Юс▒Я
ЁЯЗжЁЯЗ╢	с▒кс▒дс▒и, с▒кс▒дс▒и: с▒Яс▒▒с▒┤с▒Яс▒ис▒ас▒┤с▒дс▒ас▒Я
ЁЯЗжЁЯЗ╖	с▒кс▒дс▒и, с▒кс▒дс▒и: с▒Яс▒ис▒бс▒ос▒▒с▒┤с▒дс▒▒с▒Я
ЁЯЗжЁЯЗ╕	с▒кс▒дс▒и, с▒кс▒дс▒и: с▒Яс▒вс▒ос▒ис▒дс▒ас▒Яс▒╣с▒▒ с▒ес▒Яс▒вс▒Ъс▒гс▒Я
ЁЯЗжЁЯЗ╣	с▒кс▒дс▒и, с▒кс▒дс▒и: с▒Яс▒ес▒┤с▒ис▒ос▒Юс▒дс▒нс▒Я
ЁЯЗжЁЯЗ║	с▒кс▒дс▒и, с▒кс▒дс▒и: с▒Ъс▒ес▒┤с▒ис▒ос▒Юс▒дс▒нс▒Я
ЁЯЗжЁЯЗ╝	с▒кс▒дс▒и, с▒кс▒дс▒и: с▒Яс▒╣с▒ис▒йс▒╡с▒Я
ЁЯЗжЁЯЗ╜	с▒кс▒дс▒и, с▒кс▒дс▒и: с▒ос▒Юс▒ос▒╕с▒░ с▒лс▒гс▒дс▒пс▒лс▒│с▒Ю
ЁЯЗжЁЯЗ┐	с▒кс▒дс▒и, с▒кс▒дс▒и: с▒Яс▒╣с▒бс▒Яс▒╣с▒ис▒╡с▒ос▒нс▒бс▒Яс▒▒
ЁЯЗзЁЯЗж	с▒кс▒дс▒и, с▒кс▒дс▒и: с▒╡с▒Ъс▒ес▒▒с▒дс▒нс▒Я с▒Яс▒и с▒жс▒Яс▒╣с▒ис▒бс▒ос▒Ьс▒Ъс▒гс▒дс▒нс▒Я
ЁЯЗзЁЯЗз	с▒кс▒дс▒и, с▒кс▒дс▒и: с▒╡с▒Яс▒ис▒╡с▒Яс▒░с▒Ъс▒е
ЁЯЗзЁЯЗй	с▒кс▒дс▒и, с▒кс▒дс▒и: с▒╡с▒Яс▒Эс▒Юс▒Яс▒лс▒ос▒е
ЁЯЗзЁЯЗк	с▒кс▒дс▒и, с▒кс▒дс▒и: с▒╡с▒ос▒Юс▒бс▒дс▒нс▒Яс▒╣с▒в
ЁЯЗзЁЯЗл	с▒кс▒дс▒и, с▒кс▒дс▒и: с▒╡с▒йс▒ис▒ас▒дс▒▒с▒Я с▒пс▒╖с▒Яс▒ес▒Ъ
ЁЯЗзЁЯЗм	с▒кс▒дс▒и, с▒кс▒дс▒и: с▒╡с▒йс▒Юс▒Ьс▒Яс▒ис▒дс▒нс▒Я
ЁЯЗзЁЯЗн	с▒кс▒дс▒и, с▒кс▒дс▒и: с▒╡с▒Яс▒жс▒ис▒ос▒▒
ЁЯЗзЁЯЗо	с▒кс▒дс▒и, с▒кс▒дс▒и: с▒╡с▒йс▒ис▒йс▒▒с▒░с▒д
ЁЯЗзЁЯЗп	с▒кс▒дс▒и, с▒кс▒дс▒и: с▒╡с▒ос▒▒с▒дс▒▒
ЁЯЗзЁЯЗ▒	с▒кс▒дс▒и, с▒кс▒дс▒и: с▒ос▒е с▒┤с▒д с▒╡с▒Яс▒ис▒Ыс▒╖с▒ос▒Юс▒ос▒вс▒д
ЁЯЗзЁЯЗ▓	с▒кс▒дс▒и, с▒кс▒дс▒и: с▒╡с▒Яс▒╣с▒ис▒вс▒йс▒▒с▒░с▒Я
ЁЯЗзЁЯЗ│	с▒кс▒дс▒и, с▒кс▒дс▒и: с▒╡с▒╜с▒ис▒йс▒▒с▒ос▒н
ЁЯЗзЁЯЗ┤	с▒кс▒дс▒и, с▒кс▒дс▒и: с▒╡с▒Ъс▒Юс▒дс▒гс▒дс▒нс▒Я
ЁЯЗзЁЯЗ╢	с▒кс▒дс▒и, с▒кс▒дс▒и: с▒ас▒Яс▒╣с▒ис▒ос▒▒с▒дс▒нс▒Яс▒╣с▒▒ с▒▒с▒ос▒лс▒Ъс▒ис▒Юс▒ос▒╕с▒░
ЁЯЗзЁЯЗ╖	с▒кс▒дс▒и, с▒кс▒дс▒и: с▒╡с▒ис▒Яс▒бс▒дс▒Ю
ЁЯЗзЁЯЗ╕	с▒кс▒дс▒и, с▒кс▒дс▒и: с▒╡с▒Яс▒жс▒Яс▒вс▒Яс▒е
ЁЯЗзЁЯЗ╣	с▒кс▒дс▒и, с▒кс▒дс▒и: с▒╡с▒╖с▒йс▒┤с▒Яс▒▒
ЁЯЗзЁЯЗ╗	с▒кс▒дс▒и, с▒кс▒дс▒и: с▒╡с▒Ъс▒гс▒ос▒┤ с▒Яс▒нс▒Юс▒ос▒╕с▒░
ЁЯЗзЁЯЗ╝	с▒кс▒дс▒и, с▒кс▒дс▒и: с▒╡с▒Ъс▒┤с▒ес▒гс▒Яс▒▒с▒Я
ЁЯЗзЁЯЗ╛	с▒кс▒дс▒и, с▒кс▒дс▒и: с▒╡с▒ос▒Юс▒Яс▒ис▒йс▒е
ЁЯЗзЁЯЗ┐	с▒кс▒дс▒и, с▒кс▒дс▒и: с▒╡с▒ос▒Юс▒дс▒бс▒╜
ЁЯЗиЁЯЗж	с▒кс▒дс▒и, с▒кс▒дс▒и: с▒ас▒Яс▒▒с▒Яс▒░с▒Я
ЁЯЗиЁЯЗи	с▒кс▒дс▒и, с▒кс▒дс▒и: с▒ас▒Ъс▒ас▒Ъс▒е (с▒ас▒дс▒Юс▒дс▒Э) с▒Яс▒нс▒Юс▒ос▒╕с▒░
ЁЯЗиЁЯЗй	с▒кс▒дс▒и, с▒кс▒дс▒и: с▒ас▒Ъс▒Эс▒Ьс▒Ъ с▒╝ с▒ас▒дс▒▒с▒ес▒Яс▒ес▒Я
ЁЯЗиЁЯЗл	с▒кс▒дс▒и, с▒кс▒дс▒и: с▒Ыс▒Яс▒Юс▒Я с▒Яс▒пс▒╖с▒ис▒дс▒ас▒Я с▒Яс▒╣с▒пс▒▒с▒Яс▒╣с▒Ы
ЁЯЗиЁЯЗм	с▒кс▒дс▒и, с▒кс▒дс▒и: с▒ас▒Ъс▒Эс▒Ьс▒Ъ с▒╝ с▒╡с▒╜с▒ис▒Яс▒бс▒Яс▒гс▒дс▒Ю
ЁЯЗиЁЯЗн	с▒кс▒дс▒и, с▒кс▒дс▒и: с▒ес▒ос▒дс▒бс▒Яс▒╣с▒ис▒Юс▒ос▒╕с▒░
ЁЯЗиЁЯЗо	с▒кс▒дс▒и, с▒кс▒дс▒и: с▒ас▒Ъс▒Ыс▒о с▒лс▒дс▒гс▒Ъс▒нс▒ос▒и
ЁЯЗиЁЯЗ░	с▒кс▒дс▒и, с▒кс▒дс▒и: с▒ас▒йс▒а с▒Яс▒нс▒Юс▒ос▒╕с▒░
ЁЯЗиЁЯЗ▒	с▒кс▒дс▒и, с▒кс▒дс▒и: с▒кс▒Яс▒нс▒дс▒Ю
ЁЯЗиЁЯЗ▓	с▒кс▒дс▒и, с▒кс▒дс▒и: с▒ас▒Яс▒вс▒ос▒ис▒йс▒▒
ЁЯЗиЁЯЗ│	с▒кс▒дс▒и, с▒кс▒дс▒и: с▒кс▒дс▒▒
ЁЯЗиЁЯЗ┤	с▒кс▒дс▒и, с▒кс▒дс▒и: с▒ас▒Ъс▒Юс▒Ъс▒вс▒╡с▒дс▒нс▒Я
ЁЯЗиЁЯЗ╡	с▒кс▒дс▒и, с▒кс▒дс▒и: с▒ас▒Юс▒дс▒пс▒ос▒┤с▒ис▒Ъс▒▒ с▒Яс▒нс▒Юс▒ос▒╕с▒░
ЁЯЗиЁЯЗ╖	с▒кс▒дс▒и, с▒кс▒дс▒и: с▒ас▒Ъс▒ес▒┤с▒Я с▒ис▒дс▒ас▒Я
ЁЯЗиЁЯЗ║	с▒кс▒дс▒и, с▒кс▒дс▒и: с▒ас▒нс▒йс▒╡с▒Я
ЁЯЗиЁЯЗ╗	с▒кс▒дс▒и, с▒кс▒дс▒и: с▒ас▒ос▒п с▒гс▒Яс▒╣с▒ис▒░с▒о
ЁЯЗиЁЯЗ╝	с▒кс▒дс▒и, с▒кс▒дс▒и: с▒ас▒йс▒ис▒Яс▒ас▒Яс▒г
ЁЯЗиЁЯЗ╜	с▒кс▒дс▒и, с▒кс▒дс▒и: с▒ас▒ис▒дс▒ес▒вс▒Яс▒╣с▒е с▒Яс▒нс▒Юс▒ос▒╕с▒░
ЁЯЗиЁЯЗ╛	с▒кс▒дс▒и, с▒кс▒дс▒и: с▒ес▒Яс▒нс▒пс▒ис▒Яс▒╣с▒е
ЁЯЗиЁЯЗ┐	с▒кс▒дс▒и, с▒кс▒дс▒и: с▒кс▒ос▒ас▒дс▒нс▒Я
ЁЯЗйЁЯЗк	с▒кс▒дс▒и, с▒кс▒дс▒и: с▒бс▒Яс▒ис▒вс▒Яс▒▒с▒д
ЁЯЗйЁЯЗм	с▒кс▒дс▒и, с▒кс▒дс▒и: с▒░с▒дс▒нс▒ос▒Ьс▒Ъ с▒Ьс▒Яс▒ис▒ес▒дс▒нс▒Я
ЁЯЗйЁЯЗп	с▒кс▒дс▒и, с▒кс▒дс▒и: с▒бс▒дс▒╡с▒йс▒Ыс▒д
ЁЯЗйЁЯЗ░	с▒кс▒дс▒и, с▒кс▒дс▒и: с▒░с▒ос▒▒с▒вс▒Яс▒ис▒а
ЁЯЗйЁЯЗ▓	с▒кс▒дс▒и, с▒кс▒дс▒и: с▒░с▒Ъс▒вс▒дс▒▒с▒дс▒ас▒Я
ЁЯЗйЁЯЗ┤	с▒кс▒дс▒и, с▒кс▒дс▒и: с▒░с▒Ъс▒вс▒дс▒▒с▒дс▒ас▒Яс▒▒ с▒ис▒дс▒пс▒Ъс▒╡с▒Юс▒дс▒а
ЁЯЗйЁЯЗ┐	с▒кс▒дс▒и, с▒кс▒дс▒и: с▒Яс▒Юс▒бс▒ос▒ис▒дс▒нс▒Я
ЁЯЗкЁЯЗж	с▒кс▒дс▒и, с▒кс▒дс▒и: с▒ес▒ос▒гс▒┤с▒Я с▒Яс▒и с▒вс▒ос▒Юс▒дс▒Юс▒Я
ЁЯЗкЁЯЗи	с▒кс▒дс▒и, с▒кс▒дс▒и: с▒дс▒ас▒гс▒Яс▒░с▒Ъс▒и
ЁЯЗкЁЯЗк	с▒кс▒дс▒и, с▒кс▒дс▒и: с▒ос▒ес▒┤с▒Ъс▒▒с▒дс▒нс▒Я
ЁЯЗкЁЯЗм	с▒кс▒дс▒и, с▒кс▒дс▒и: с▒дс▒бс▒дс▒пс▒┤
ЁЯЗкЁЯЗн	с▒кс▒дс▒и, с▒кс▒дс▒и: с▒пс▒Яс▒кс▒о с▒ес▒Яс▒жс▒Яс▒ис▒Я
ЁЯЗкЁЯЗ╖	с▒кс▒дс▒и, с▒кс▒дс▒и: с▒дс▒ис▒дс▒┤с▒ис▒дс▒нс▒Я
ЁЯЗкЁЯЗ╕	с▒кс▒дс▒и, с▒кс▒дс▒и: с▒ес▒пс▒ос▒▒
ЁЯЗкЁЯЗ╣	с▒кс▒дс▒и, с▒кс▒дс▒и: с▒дс▒Ыс▒╖с▒дс▒нс▒Ъс▒пс▒дс▒нс▒Я
ЁЯЗкЁЯЗ║	с▒кс▒дс▒и, с▒кс▒дс▒и: с▒нс▒йс▒ис▒Ъс▒пс▒дс▒нс▒Яс▒╣с▒▒ с▒бс▒йс▒вс▒дс▒л
ЁЯЗлЁЯЗо	с▒кс▒дс▒и, с▒кс▒дс▒и: с▒пс▒╖с▒дс▒▒с▒Юс▒ос▒╕с▒░
ЁЯЗлЁЯЗп	с▒кс▒дс▒и, с▒кс▒дс▒и: с▒пс▒╖с▒дс▒бс▒д
ЁЯЗлЁЯЗ░	с▒кс▒дс▒и, с▒кс▒дс▒и: с▒пс▒╖с▒Яс▒Юс▒ас▒Юс▒ос▒╕с▒░ с▒Яс▒нс▒Юс▒ос▒╕с▒░
ЁЯЗлЁЯЗ▓	с▒кс▒дс▒и, с▒кс▒дс▒и: с▒вс▒Яс▒нс▒ас▒ис▒Ъс▒▒с▒ос▒ес▒дс▒нс▒Я
ЁЯЗлЁЯЗ┤	с▒кс▒дс▒и, с▒кс▒дс▒и: с▒пс▒╖с▒ос▒ис▒Ъ с▒лс▒гс▒дс▒пс▒лс▒│с▒Ю
ЁЯЗлЁЯЗ╖	с▒кс▒дс▒и, с▒кс▒дс▒и: с▒пс▒╖с▒ис▒Яс▒▒с▒е
ЁЯЗмЁЯЗж	с▒кс▒дс▒и, с▒кс▒дс▒и: с▒Ьс▒Яс▒╡с▒Ъс▒▒
ЁЯЗмЁЯЗз	с▒кс▒дс▒и, с▒кс▒дс▒и: с▒нс▒йс▒▒с▒дс▒нс▒┤с▒ос▒░ с▒ас▒дс▒Эс▒░с▒Ъс▒в
ЁЯЗмЁЯЗй	с▒кс▒дс▒и, с▒кс▒дс▒и: с▒Ьс▒╜с▒ис▒ос▒▒с▒Яс▒░с▒Я
ЁЯЗмЁЯЗк	с▒кс▒дс▒и, с▒кс▒дс▒и: с▒бс▒нс▒Ъс▒ис▒бс▒дс▒нс▒Я
ЁЯЗмЁЯЗл	с▒кс▒дс▒и, с▒кс▒дс▒и: с▒пс▒╖с▒ис▒ос▒зс▒к с▒Ьс▒йс▒нс▒Яс▒▒с▒Я
ЁЯЗмЁЯЗм	с▒кс▒дс▒и, с▒кс▒дс▒и: с▒Ьс▒гс▒ос▒ис▒▒с▒ос▒ес▒н
ЁЯЗмЁЯЗн	с▒кс▒дс▒и, с▒кс▒дс▒и: с▒Ьс▒╖с▒Яс▒▒с▒Я
ЁЯЗмЁЯЗо	с▒кс▒дс▒и, с▒кс▒дс▒и: с▒Ьс▒дс▒╡с▒╜с▒ис▒Яс▒Юс▒┤с▒Яс▒╣с▒и
ЁЯЗмЁЯЗ▒	с▒кс▒дс▒и, с▒кс▒дс▒и: с▒Ьс▒╜с▒ис▒дс▒▒с▒Юс▒ос▒╕с▒░
ЁЯЗмЁЯЗ▓	с▒кс▒дс▒и, с▒кс▒дс▒и: с▒Ьс▒Яс▒вс▒╡с▒дс▒нс▒Я
ЁЯЗмЁЯЗ│	с▒кс▒дс▒и, с▒кс▒дс▒и: с▒Ьс▒йс▒нс▒▒с▒дс▒нс▒Я
ЁЯЗмЁЯЗ╡	с▒кс▒дс▒и, с▒кс▒дс▒и: с▒Ьс▒йс▒Яс▒░с▒ос▒Юс▒Ъс▒гс▒п
ЁЯЗмЁЯЗ╢	с▒кс▒дс▒и, с▒кс▒дс▒и: с▒дс▒ас▒гс▒дс▒┤с▒Ъс▒ис▒дс▒нс▒Яс▒╣с▒Ю с▒Ьс▒дс▒▒с▒д
ЁЯЗмЁЯЗ╖	с▒кс▒дс▒и, с▒кс▒дс▒и: с▒Ьс▒╜с▒ис▒дс▒е
ЁЯЗмЁЯЗ╕	с▒кс▒дс▒и, с▒кс▒дс▒и: с▒ас▒Ъс▒╕с▒нс▒о с▒бс▒дс▒нс▒Ъс▒ис▒бс▒дс▒нс▒Я с▒Яс▒и с▒ас▒Ъс▒╕с▒нс▒о с▒ес▒ос▒╕с▒░с▒гс▒дс▒к с▒Яс▒нс▒Юс▒ос▒╕с▒░
ЁЯЗмЁЯЗ╣	с▒кс▒дс▒и, с▒кс▒дс▒и: с▒Ьс▒йс▒гс▒Яс▒┤с▒ос▒вс▒Яс▒Юс▒Я
ЁЯЗмЁЯЗ║	с▒кс▒дс▒и, с▒кс▒дс▒и: с▒Ьс▒йс▒гс▒Яс▒в
ЁЯЗмЁЯЗ╝	с▒кс▒дс▒и, с▒кс▒дс▒и: с▒Ьс▒йс▒нс▒▒с▒дс▒нс▒Яс▒╝с▒╡с▒дс▒ес▒Яс▒г
ЁЯЗмЁЯЗ╛	с▒кс▒дс▒и, с▒кс▒дс▒и: с▒Ьс▒йс▒нс▒Яс▒▒с▒Я
ЁЯЗнЁЯЗ░	с▒кс▒дс▒и, с▒кс▒дс▒и: с▒жс▒Ъс▒Э с▒ас▒Ъс▒Э с▒ес▒Яс▒и с▒кс▒Яс▒нс▒▒с▒Я
ЁЯЗнЁЯЗ▓	с▒кс▒дс▒и, с▒кс▒дс▒и: с▒жс▒Яс▒╣с▒░ с▒Яс▒и с▒вс▒ос▒ас▒░с▒Ъс▒▒с▒Яс▒╣с▒Юс▒░ с▒Яс▒нс▒Юс▒ос▒╕с▒░
ЁЯЗнЁЯЗ│	с▒кс▒дс▒и, с▒кс▒дс▒и: с▒жс▒Ъс▒▒с▒░с▒йс▒ис▒Яс▒е
ЁЯЗнЁЯЗ╖	с▒кс▒дс▒и, с▒кс▒дс▒и: с▒ас▒ис▒Ъс▒ос▒ес▒дс▒нс▒Я
ЁЯЗнЁЯЗ╣	с▒кс▒дс▒и, с▒кс▒дс▒и: с▒жс▒Яс▒нс▒┤с▒д
ЁЯЗнЁЯЗ║	с▒кс▒дс▒и, с▒кс▒дс▒и: с▒жс▒Яс▒╣с▒Эс▒Ьс▒Яс▒ис▒д
ЁЯЗоЁЯЗи	с▒кс▒дс▒и, с▒кс▒дс▒и: с▒ас▒Яс▒▒с▒Яс▒ис▒н с▒Яс▒нс▒Юс▒ос▒╕с▒░с▒е
ЁЯЗоЁЯЗй	с▒кс▒дс▒и, с▒кс▒дс▒и: с▒дс▒▒с▒░с▒Ъс▒▒с▒ос▒ес▒дс▒нс▒Я
ЁЯЗоЁЯЗк	с▒кс▒дс▒и, с▒кс▒дс▒и: с▒Яс▒нс▒Яс▒╣с▒ис▒Юс▒ос▒╕с▒░
ЁЯЗоЁЯЗ▒	с▒кс▒дс▒и, с▒кс▒дс▒и: с▒дс▒ес▒ис▒Яс▒нс▒ос▒Ю
ЁЯЗоЁЯЗ▓	с▒кс▒дс▒и, с▒кс▒дс▒и: с▒Яс▒нс▒Ю с▒Ъс▒пс▒╖ с▒вс▒ос▒▒
ЁЯЗоЁЯЗ│	с▒кс▒дс▒и, с▒кс▒дс▒и: с▒дс▒▒с▒░с▒дс▒нс▒Я
ЁЯЗоЁЯЗ┤	с▒кс▒дс▒и, с▒кс▒дс▒и: с▒╡с▒╜с▒ис▒дс▒┤с▒дс▒е с▒╡с▒╖с▒Яс▒ис▒Ъс▒Ы с▒вс▒Яс▒жс▒Яс▒ес▒Яс▒Ьс▒Ъс▒и с▒бс▒Яс▒нс▒Ьс▒Я
ЁЯЗоЁЯЗ╢	с▒кс▒дс▒и, с▒кс▒дс▒и: с▒дс▒ис▒Яс▒а
ЁЯЗоЁЯЗ╖	с▒кс▒дс▒и, с▒кс▒дс▒и: с▒дс▒ис▒Яс▒▒
ЁЯЗоЁЯЗ╕	с▒кс▒дс▒и, с▒кс▒дс▒и: с▒Яс▒нс▒ес▒Юс▒ос▒╕с▒░
ЁЯЗоЁЯЗ╣	с▒кс▒дс▒и, с▒кс▒дс▒и: с▒дс▒┤с▒Юс▒д
ЁЯЗпЁЯЗк	с▒кс▒дс▒и, с▒кс▒дс▒и: с▒бс▒Яс▒╣с▒ис▒ес▒д
ЁЯЗпЁЯЗ▓	с▒кс▒дс▒и, с▒кс▒дс▒и: с▒бс▒Яс▒вс▒Яс▒нс▒ас▒Я
ЁЯЗпЁЯЗ┤	с▒кс▒дс▒и, с▒кс▒дс▒и: с▒бс▒Ъс▒ис▒░с▒Яс▒▒
ЁЯЗпЁЯЗ╡	с▒кс▒дс▒и, с▒кс▒дс▒и: с▒бс▒Яс▒пс▒Яс▒▒
ЁЯЗ░ЁЯЗк	с▒кс▒дс▒и, с▒кс▒дс▒и: с▒ас▒ос▒▒с▒нс▒Я
ЁЯЗ░ЁЯЗм	с▒кс▒дс▒и, с▒кс▒дс▒и: с▒ас▒дс▒ис▒Ьс▒дс▒ес▒Ыс▒Яс▒▒
ЁЯЗ░ЁЯЗн	с▒кс▒дс▒и, с▒кс▒дс▒и: с▒ас▒Яс▒╣с▒вс▒╡с▒Ъс▒░с▒дс▒нс▒Я
ЁЯЗ░ЁЯЗо	с▒кс▒дс▒и, с▒кс▒дс▒и: с▒ас▒дс▒ис▒дс▒╡с▒Ъс▒Ыс▒д
ЁЯЗ░ЁЯЗ▓	с▒кс▒дс▒и, с▒кс▒дс▒и: с▒ас▒Ъс▒вс▒Ъс▒ис▒Ъс▒е
ЁЯЗ░ЁЯЗ│	с▒кс▒дс▒и, с▒кс▒дс▒и: с▒ос▒е с▒┤с▒д с▒ас▒дс▒┤с▒е с▒Яс▒и с▒▒с▒ос▒гс▒дс▒е
ЁЯЗ░ЁЯЗ╡	с▒кс▒дс▒и, с▒кс▒дс▒и: с▒ос▒Ыс▒Ъс▒в с▒ас▒Ъс▒ис▒дс▒нс▒Я
ЁЯЗ░ЁЯЗ╖	с▒кс▒дс▒и, с▒кс▒дс▒и: с▒ас▒Ъс▒зс▒о с▒ас▒Ъс▒ис▒дс▒нс▒Я
ЁЯЗ░ЁЯЗ╝	с▒кс▒дс▒и, с▒кс▒дс▒и: с▒ас▒йс▒гс▒Яс▒╣с▒нс▒Ы
ЁЯЗ░ЁЯЗ╛	с▒кс▒дс▒и, с▒кс▒дс▒и: с▒ас▒ос▒вс▒ос▒▒ с▒Яс▒нс▒Юс▒ос▒╕с▒░с▒е
ЁЯЗ░ЁЯЗ┐	с▒кс▒дс▒и, с▒кс▒дс▒и: с▒ас▒Яс▒бс▒Яс▒ас▒╖с▒Яс▒ес▒Ыс▒╖с▒Яс▒▒
ЁЯЗ▒ЁЯЗж	с▒кс▒дс▒и, с▒кс▒дс▒и: с▒Юс▒Яс▒гс▒Ъс▒е
ЁЯЗ▒ЁЯЗз	с▒кс▒дс▒и, с▒кс▒дс▒и: с▒Юс▒ос▒╡с▒Яс▒▒с▒Яс▒▒
ЁЯЗ▒ЁЯЗи	с▒кс▒дс▒и, с▒кс▒дс▒и: с▒ос▒е с▒┤с▒д с▒Юс▒йс▒ес▒дс▒нс▒Я
ЁЯЗ▒ЁЯЗо	с▒кс▒дс▒и, с▒кс▒дс▒и: с▒Юс▒дс▒кс▒ос▒ес▒┤с▒дс▒▒
ЁЯЗ▒ЁЯЗ░	с▒кс▒дс▒и, с▒кс▒дс▒и: с▒ес▒ис▒д с▒Юс▒Ъс▒Эс▒Я
ЁЯЗ▒ЁЯЗ╖	с▒кс▒дс▒и, с▒кс▒дс▒и: с▒Юс▒Яс▒нс▒╡с▒ос▒ис▒дс▒нс▒Я
ЁЯЗ▒ЁЯЗ╕	с▒кс▒дс▒и, с▒кс▒дс▒и: с▒Юс▒ос▒ес▒Ъс▒Ыс▒╖с▒Ъ
ЁЯЗ▒ЁЯЗ╣	с▒кс▒дс▒и, с▒кс▒дс▒и: с▒Юс▒дс▒Ыс▒╖с▒йс▒гс▒Яс▒▒с▒дс▒нс▒Я
ЁЯЗ▒ЁЯЗ║	с▒кс▒дс▒и, с▒кс▒дс▒и: с▒Юс▒дс▒ас▒бс▒Яс▒╣с▒вс▒╡с▒Яс▒╣с▒ис▒Ьс▒╜
ЁЯЗ▒ЁЯЗ╗	с▒кс▒дс▒и, с▒кс▒дс▒и: с▒Юс▒Яс▒Ыс▒гс▒дс▒нс▒Я
ЁЯЗ▒ЁЯЗ╛	с▒кс▒дс▒и, с▒кс▒дс▒и: с▒Юс▒дс▒╡с▒нс▒Я
ЁЯЗ▓ЁЯЗж	с▒кс▒дс▒и, с▒кс▒дс▒и: с▒вс▒Ъс▒ис▒Ъс▒ас▒Ъ
ЁЯЗ▓ЁЯЗи	с▒кс▒дс▒и, с▒кс▒дс▒и: с▒вс▒Ъс▒▒с▒Яс▒ас▒Ъ
ЁЯЗ▓ЁЯЗй	с▒кс▒дс▒и, с▒кс▒дс▒и: с▒вс▒Ъс▒Юс▒░с▒Ъс▒гс▒Я
ЁЯЗ▓ЁЯЗк	с▒кс▒дс▒и, с▒кс▒дс▒и: с▒вс▒Ъс▒▒с▒┤с▒ос▒▒с▒Ьс▒╜с▒ис▒Ъ
ЁЯЗ▓ЁЯЗл	с▒кс▒дс▒и, с▒кс▒дс▒и: с▒ос▒е с▒┤с▒д с▒вс▒Яс▒ис▒┤с▒дс▒▒
ЁЯЗ▓ЁЯЗм	с▒кс▒дс▒и, с▒кс▒дс▒и: с▒вс▒Яс▒░с▒Яс▒Ьс▒Яс▒ес▒ас▒Ъс▒и
ЁЯЗ▓ЁЯЗн	с▒кс▒дс▒и, с▒кс▒дс▒и: с▒вс▒Яс▒ис▒ес▒Яс▒Ю с▒Яс▒нс▒Юс▒ос▒╕с▒░
ЁЯЗ▓ЁЯЗ░	с▒кс▒дс▒и, с▒кс▒дс▒и: с▒ос▒Ыс▒Ъс▒в с▒вс▒Яс▒ес▒ос▒░с▒Ъс▒▒с▒дс▒нс▒Я
ЁЯЗ▓ЁЯЗ▒	с▒кс▒дс▒и, с▒кс▒дс▒и: с▒вс▒Яс▒Юс▒д
ЁЯЗ▓ЁЯЗ▓	с▒кс▒дс▒и, с▒кс▒дс▒и: с▒вс▒нс▒Яс▒▒с▒вс▒Яс▒и (с▒╡с▒Яс▒╣с▒ис▒вс▒Я)
ЁЯЗ▓ЁЯЗ│	с▒кс▒дс▒и, с▒кс▒дс▒и: с▒вс▒Ъс▒Эс▒Ьс▒Ъс▒Юс▒дс▒нс▒Я
ЁЯЗ▓ЁЯЗ┤	с▒кс▒дс▒и, с▒кс▒дс▒и: с▒вс▒Яс▒ас▒Яс▒г с▒ес▒Яс▒и с▒кс▒Яс▒нс▒▒с▒Я
ЁЯЗ▓ЁЯЗ╡	с▒кс▒дс▒и, с▒кс▒дс▒и: с▒ос▒Ыс▒Ъс▒в с▒вс▒Яс▒ис▒дс▒нс▒Яс▒▒с▒Я с▒Яс▒нс▒Юс▒ос▒╕с▒░
ЁЯЗ▓ЁЯЗ╢	с▒кс▒дс▒и, с▒кс▒дс▒и: с▒вс▒Яс▒ис▒┤с▒дс▒▒с▒ас▒дс▒г
ЁЯЗ▓ЁЯЗ╖	с▒кс▒дс▒и, с▒кс▒дс▒и: с▒вс▒Яс▒гс▒ис▒дс▒┤с▒Яс▒▒с▒дс▒нс▒Я
ЁЯЗ▓ЁЯЗ╕	с▒кс▒дс▒и, с▒кс▒дс▒и: с▒вс▒Ъс▒▒с▒┤с▒ес▒ос▒ис▒Яс▒┤
ЁЯЗ▓ЁЯЗ╣	с▒кс▒дс▒и, с▒кс▒дс▒и: с▒вс▒Яс▒Юс▒┤с▒Я
ЁЯЗ▓ЁЯЗ║	с▒кс▒дс▒и, с▒кс▒дс▒и: с▒вс▒Ъс▒ис▒дс▒ес▒Яс▒╣с▒е
ЁЯЗ▓ЁЯЗ╗	с▒кс▒дс▒и, с▒кс▒дс▒и: с▒вс▒Яс▒Юс▒░с▒дс▒╡с▒╖с▒е
ЁЯЗ▓ЁЯЗ╝	с▒кс▒дс▒и, с▒кс▒дс▒и: с▒вс▒Яс▒╣с▒Юс▒Яс▒гс▒д
ЁЯЗ▓ЁЯЗ╜	с▒кс▒дс▒и, с▒кс▒дс▒и: с▒вс▒ос▒ас▒ес▒дс▒ас▒Ъ
ЁЯЗ▓ЁЯЗ╛	с▒кс▒дс▒и, с▒кс▒дс▒и: с▒вс▒Яс▒╣с▒Юс▒ос▒ес▒дс▒нс▒Я
ЁЯЗ▓ЁЯЗ┐	с▒кс▒дс▒и, с▒кс▒дс▒и: с▒вс▒Ъс▒бс▒Яс▒вс▒╡с▒дс▒а
ЁЯЗ│ЁЯЗж	с▒кс▒дс▒и, с▒кс▒дс▒и: с▒▒с▒Яс▒вс▒дс▒╡с▒дс▒нс▒Я
ЁЯЗ│ЁЯЗи	с▒кс▒дс▒и, с▒кс▒дс▒и: с▒▒с▒Яс▒╢с▒Я с▒ас▒Яс▒Юс▒ос▒░с▒Ъс▒▒с▒дс▒нс▒Я
ЁЯЗ│ЁЯЗк	с▒кс▒дс▒и, с▒кс▒дс▒и: с▒▒с▒Яс▒нс▒бс▒Яс▒╣с▒и
ЁЯЗ│ЁЯЗл	с▒кс▒дс▒и, с▒кс▒дс▒и: с▒▒с▒Ъс▒ис▒пс▒╖с▒Ъс▒Юс▒а с▒Яс▒нс▒Юс▒ос▒╕с▒░
ЁЯЗ│ЁЯЗм	с▒кс▒дс▒и, с▒кс▒дс▒и: с▒▒с▒Яс▒нс▒бс▒ос▒ис▒дс▒нс▒Я
ЁЯЗ│ЁЯЗо	с▒кс▒дс▒и, с▒кс▒дс▒и: с▒▒с▒дс▒ас▒Яс▒ис▒Яс▒Ьс▒йс▒гс▒Я
ЁЯЗ│ЁЯЗ▒	с▒кс▒дс▒и, с▒кс▒дс▒и: с▒▒с▒ос▒лс▒Ъс▒ис▒Юс▒ос▒╕с▒░
ЁЯЗ│ЁЯЗ┤	с▒кс▒дс▒и, с▒кс▒дс▒и: с▒▒с▒Ъс▒ис▒гс▒о
ЁЯЗ│ЁЯЗ╡	с▒кс▒дс▒и, с▒кс▒дс▒и: с▒▒с▒ос▒пс▒Яс▒Ю
ЁЯЗ│ЁЯЗ╖	с▒кс▒дс▒и, с▒кс▒дс▒и: с▒▒с▒Яс▒╢с▒ис▒й
ЁЯЗ│ЁЯЗ║	с▒кс▒дс▒и, с▒кс▒дс▒и: с▒▒с▒Яс▒нс▒й
ЁЯЗ│ЁЯЗ┐	с▒кс▒дс▒и, с▒кс▒дс▒и: с▒▒с▒дс▒нс▒й с▒бс▒дс▒Юс▒ос▒╕с▒░
ЁЯЗ┤ЁЯЗ▓	с▒кс▒дс▒и, с▒кс▒дс▒и: с▒│с▒вс▒Яс▒▒
ЁЯЗ╡ЁЯЗж	с▒кс▒дс▒и, с▒кс▒дс▒и: с▒пс▒Яс▒▒с▒Яс▒вс▒Я
ЁЯЗ╡ЁЯЗк	с▒кс▒дс▒и, с▒кс▒дс▒и: с▒пс▒ос▒ис▒й
ЁЯЗ╡ЁЯЗл	с▒кс▒дс▒и, с▒кс▒дс▒и: с▒пс▒╖с▒ис▒ос▒зс▒к с▒пс▒Ъс▒Юс▒дс▒▒с▒ос▒ес▒дс▒нс▒Я
ЁЯЗ╡ЁЯЗм	с▒кс▒дс▒и, с▒кс▒дс▒и: с▒пс▒Яс▒╣с▒пс▒йс▒гс▒Я с▒▒с▒Яс▒╢с▒Я с▒бс▒дс▒▒с▒дс▒нс▒Я
ЁЯЗ╡ЁЯЗн	с▒кс▒дс▒и, с▒кс▒дс▒и: с▒пс▒╖с▒дс▒Юс▒дс▒пс▒дс▒▒с▒е
ЁЯЗ╡ЁЯЗ░	с▒кс▒дс▒и, с▒кс▒дс▒и: с▒пс▒Яс▒ас▒ос▒ес▒Ыс▒Яс▒▒
ЁЯЗ╡ЁЯЗ▒	с▒кс▒дс▒и, с▒кс▒дс▒и: с▒пс▒Ъс▒Юс▒ос▒╕с▒░
ЁЯЗ╡ЁЯЗ▓	с▒кс▒дс▒и, с▒кс▒дс▒и: с▒ос▒е с▒┤с▒д с▒пс▒Яс▒нс▒ис▒о с▒Яс▒и с▒вс▒дс▒ас▒гс▒ос▒Юс▒ос▒▒
ЁЯЗ╡ЁЯЗ│	с▒кс▒дс▒и, с▒кс▒дс▒и: с▒пс▒дс▒┤с▒ас▒ос▒ис▒▒ с▒Яс▒нс▒Юс▒ос▒╕с▒░
ЁЯЗ╡ЁЯЗ╖	с▒кс▒дс▒и, с▒кс▒дс▒и: с▒пс▒йс▒гс▒ос▒ис▒┤с▒Ъ с▒ис▒дс▒ас▒Ъ
ЁЯЗ╡ЁЯЗ╕	с▒кс▒дс▒и, с▒кс▒дс▒и: с▒пс▒Яс▒Юс▒ос▒ес▒┤с▒дс▒▒с▒дс▒нс▒Яс▒╣с▒▒ с▒бс▒Яс▒нс▒Ьс▒Я
ЁЯЗ╡ЁЯЗ╣	с▒кс▒дс▒и, с▒кс▒дс▒и: с▒пс▒Ъс▒ис▒Ыс▒йс▒Ьс▒Яс▒Ю
ЁЯЗ╡ЁЯЗ╝	с▒кс▒дс▒и, с▒кс▒дс▒и: с▒пс▒Яс▒Юс▒Яс▒г
ЁЯЗ╡ЁЯЗ╛	с▒кс▒дс▒и, с▒кс▒дс▒и: с▒пс▒Яс▒ис▒Яс▒Ьс▒йс▒гс▒о
ЁЯЗ╢ЁЯЗж	с▒кс▒дс▒и, с▒кс▒дс▒и: с▒ас▒Ъс▒Ыс▒Ъс▒и
ЁЯЗ╖ЁЯЗк	с▒кс▒дс▒и, с▒кс▒дс▒и: с▒ис▒дс▒нс▒йс▒▒с▒дс▒нс▒Яс▒╣с▒▒
ЁЯЗ╖ЁЯЗ┤	с▒кс▒дс▒и, с▒кс▒дс▒и: с▒ис▒Ъс▒вс▒Яс▒▒с▒дс▒нс▒Я
ЁЯЗ╖ЁЯЗ╕	с▒кс▒дс▒и, с▒кс▒дс▒и: с▒ес▒Яс▒╣с▒ис▒╡с▒дс▒нс▒Я
ЁЯЗ╖ЁЯЗ║	с▒кс▒дс▒и, с▒кс▒дс▒и: с▒ис▒йс▒е
ЁЯЗ╖ЁЯЗ╝	с▒кс▒дс▒и, с▒кс▒дс▒и: с▒ис▒Яс▒╣с▒гс▒Яс▒╣с▒▒с▒░с▒Я
ЁЯЗ╕ЁЯЗж	с▒кс▒дс▒и, с▒кс▒дс▒и: с▒ес▒Яс▒╣с▒гс▒лс▒д с▒Ъс▒ис▒Ъс▒╡
ЁЯЗ╕ЁЯЗз	с▒кс▒дс▒и, с▒кс▒дс▒и: с▒ес▒Ъс▒Юс▒Ъс▒вс▒Ъс▒▒ с▒Яс▒нс▒Юс▒ос▒╕с▒░
ЁЯЗ╕ЁЯЗи	с▒кс▒дс▒и, с▒кс▒дс▒и: с▒ес▒ос▒ес▒ос▒Юс▒е
ЁЯЗ╕ЁЯЗй	с▒кс▒дс▒и, с▒кс▒дс▒и: с▒ес▒йс▒лс▒Яс▒▒
ЁЯЗ╕ЁЯЗк	с▒кс▒дс▒и, с▒кс▒дс▒и: с▒ес▒гс▒дс▒░с▒ос▒▒
ЁЯЗ╕ЁЯЗм	с▒кс▒дс▒и, с▒кс▒дс▒и: с▒ес▒дс▒Эс▒Ьс▒Яс▒пс▒йс▒и
ЁЯЗ╕ЁЯЗн	с▒кс▒дс▒и, с▒кс▒дс▒и: с▒ос▒е с▒┤с▒д с▒жс▒ос▒Юс▒ос▒▒с▒Я
ЁЯЗ╕ЁЯЗо	с▒кс▒дс▒и, с▒кс▒дс▒и: с▒ес▒Юс▒Ъс▒гс▒ос▒▒с▒дс▒нс▒Я
ЁЯЗ╕ЁЯЗп	с▒кс▒дс▒и, с▒кс▒дс▒и: с▒ес▒гс▒Яс▒Юс▒╡с▒Яс▒░ с▒Яс▒и с▒бс▒Яс▒▒ с▒вс▒Яс▒нс▒ос▒▒
ЁЯЗ╕ЁЯЗ░	с▒кс▒дс▒и, с▒кс▒дс▒и: с▒ес▒Юс▒Ъс▒гс▒ос▒ас▒дс▒нс▒Я
ЁЯЗ╕ЁЯЗ▒	с▒кс▒дс▒и, с▒кс▒дс▒и: с▒ес▒Яс▒нс▒ис▒Я с▒Юс▒ос▒нс▒Ъс▒▒с▒д
ЁЯЗ╕ЁЯЗ▓	с▒кс▒дс▒и, с▒кс▒дс▒и: с▒ес▒Яс▒▒ с▒вс▒Яс▒ис▒дс▒▒с▒Ъ
ЁЯЗ╕ЁЯЗ│	с▒кс▒дс▒и, с▒кс▒дс▒и: с▒ес▒ос▒▒с▒ос▒Ьс▒Ъс▒Ю
ЁЯЗ╕ЁЯЗ┤	с▒кс▒дс▒и, с▒кс▒дс▒и: с▒ес▒Ъс▒вс▒Яс▒Юс▒дс▒нс▒Я
ЁЯЗ╕ЁЯЗ╖	с▒кс▒дс▒и, с▒кс▒дс▒и: с▒ес▒йс▒ис▒дс▒▒с▒Яс▒в
ЁЯЗ╕ЁЯЗ╕	с▒кс▒дс▒и, с▒кс▒дс▒и: с▒ас▒Ъс▒зс▒о с▒ес▒йс▒лс▒Яс▒▒
ЁЯЗ╕ЁЯЗ╣	с▒кс▒дс▒и, с▒кс▒дс▒и: с▒ес▒Яс▒г с▒┤с▒Ъс▒в с▒Яс▒и с▒пс▒ис▒дс▒▒с▒ес▒дс▒пс▒о
ЁЯЗ╕ЁЯЗ╗	с▒кс▒дс▒и, с▒кс▒дс▒и: с▒ос▒Ю с▒ес▒Яс▒Юс▒гс▒Яс▒░с▒Ъс▒и
ЁЯЗ╕ЁЯЗ╜	с▒кс▒дс▒и, с▒кс▒дс▒и: с▒ес▒дс▒▒с▒┤ с▒вс▒Яс▒ис▒┤с▒ос▒▒
ЁЯЗ╕ЁЯЗ╛	с▒кс▒дс▒и, с▒кс▒дс▒и: с▒ес▒дс▒ис▒дс▒нс▒Я
ЁЯЗ╕ЁЯЗ┐	с▒кс▒дс▒и, с▒кс▒дс▒и: с▒ос▒ес▒гс▒Яс▒┤с▒дс▒▒с▒Я
ЁЯЗ╣ЁЯЗж	с▒кс▒дс▒и, с▒кс▒дс▒и: с▒Ыс▒ис▒дс▒ес▒Ыс▒Яс▒▒ с▒░с▒Я с▒ас▒йс▒▒с▒жс▒Я
ЁЯЗ╣ЁЯЗи	с▒кс▒дс▒и, с▒кс▒дс▒и: с▒Ыс▒йс▒ис▒ас▒е с▒Яс▒и с▒ас▒Яс▒нс▒ас▒Ъс▒е с▒Яс▒нс▒Юс▒ос▒╕с▒░
ЁЯЗ╣ЁЯЗй	с▒кс▒дс▒и, с▒кс▒дс▒и: с▒кс▒Яс▒░
ЁЯЗ╣ЁЯЗл	с▒кс▒дс▒и, с▒кс▒дс▒и: с▒пс▒╖с▒ис▒Яс▒▒с▒ес▒дс▒е с▒ас▒Ъс▒зс▒о с▒бс▒Яс▒нс▒Ьс▒Я
ЁЯЗ╣ЁЯЗм	с▒кс▒дс▒и, с▒кс▒дс▒и: с▒┤с▒Ъс▒Ьс▒Ъ
ЁЯЗ╣ЁЯЗн	с▒кс▒дс▒и, с▒кс▒дс▒и: с▒Ыс▒╖с▒Яс▒нс▒Юс▒ос▒╕с▒░
ЁЯЗ╣ЁЯЗп	с▒кс▒дс▒и, с▒кс▒дс▒и: с▒Ыс▒Яс▒бс▒дс▒ас▒дс▒ес▒Ыс▒Яс▒▒
ЁЯЗ╣ЁЯЗ░	с▒кс▒дс▒и, с▒кс▒дс▒и: с▒┤с▒Ъс▒ас▒ос▒Юс▒Яс▒г
ЁЯЗ╣ЁЯЗ▒	с▒кс▒дс▒и, с▒кс▒дс▒и: с▒┤с▒дс▒вс▒Ъс▒ис▒╝с▒Юс▒ос▒ес▒┤с▒о
ЁЯЗ╣ЁЯЗ▓	с▒кс▒дс▒и, с▒кс▒дс▒и: с▒Ыс▒йс▒ис▒ас▒вс▒ос▒▒с▒дс▒ес▒Ыс▒Яс▒▒
ЁЯЗ╣ЁЯЗ│	с▒кс▒дс▒и, с▒кс▒дс▒и: с▒┤с▒йс▒▒с▒дс▒ес▒дс▒нс▒Я
ЁЯЗ╣ЁЯЗ┤	с▒кс▒дс▒и, с▒кс▒дс▒и: с▒┤с▒Ъс▒Эс▒Ьс▒Я
ЁЯЗ╣ЁЯЗ╖	с▒кс▒дс▒и, с▒кс▒дс▒и: с▒Ыс▒Яс▒╣с▒ис▒ас▒д
ЁЯЗ╣ЁЯЗ╣	с▒кс▒дс▒и, с▒кс▒дс▒и: с▒┤с▒ис▒дс▒▒с▒дс▒░с▒Яс▒░ с▒Яс▒и с▒┤с▒Ъс▒╡с▒Яс▒Ьс▒Ъ
ЁЯЗ╣ЁЯЗ╗	с▒кс▒дс▒и, с▒кс▒дс▒и: с▒┤с▒йс▒гс▒Яс▒Юс▒й
ЁЯЗ╣ЁЯЗ╝	с▒кс▒дс▒и, с▒кс▒дс▒и: с▒Ыс▒Яс▒нс▒гс▒Яс▒▒
ЁЯЗ╣ЁЯЗ┐	с▒кс▒дс▒и, с▒кс▒дс▒и: с▒Ыс▒Яс▒╣с▒▒с▒бс▒Яс▒▒с▒дс▒нс▒Я
ЁЯЗ║ЁЯЗж	с▒кс▒дс▒и, с▒кс▒дс▒и: с▒нс▒йс▒ас▒ис▒ос▒▒
ЁЯЗ║ЁЯЗм	с▒кс▒дс▒и, с▒кс▒дс▒и: с▒йс▒Ьс▒Яс▒▒с▒░с▒Я
ЁЯЗ║ЁЯЗ▓	с▒кс▒дс▒и, с▒кс▒дс▒и: с▒нс▒й с▒ос▒е с▒╡с▒Яс▒╖с▒ис▒о с▒Яс▒нс▒Юс▒ос▒╕с▒░
ЁЯЗ║ЁЯЗ│	с▒кс▒дс▒и, с▒кс▒дс▒и: с▒бс▒йс▒вс▒дс▒л с▒лс▒дс▒ес▒Ъс▒в
ЁЯЗ║ЁЯЗ╕	с▒кс▒дс▒и, с▒кс▒дс▒и: с▒нс▒йс▒▒с▒Яс▒нс▒┤с▒ос▒░ с▒ос▒ес▒┤с▒ос▒┤
ЁЯЗ║ЁЯЗ╛	с▒кс▒дс▒и, с▒кс▒дс▒и: с▒йс▒ис▒йс▒Ьс▒йс▒гс▒о
ЁЯЗ║ЁЯЗ┐	с▒кс▒дс▒и, с▒кс▒дс▒и: с▒йс▒бс▒╜с▒╡с▒ос▒ас▒дс▒ес▒Ыс▒Яс▒▒
ЁЯЗ╗ЁЯЗж	с▒кс▒дс▒и, с▒кс▒дс▒и: с▒гс▒Яс▒┤с▒дс▒ас▒Яс▒▒ с▒ес▒Ъс▒жс▒Ъс▒и
ЁЯЗ╗ЁЯЗи	с▒кс▒дс▒и, с▒кс▒дс▒и: с▒ос▒е с▒┤с▒д с▒╡с▒╖с▒дс▒▒с▒ес▒ос▒┤ с▒Яс▒и с▒Ьс▒╜с▒ис▒ос▒▒с▒Яс▒░с▒дс▒▒с▒е
ЁЯЗ╗ЁЯЗк	с▒кс▒дс▒и, с▒кс▒дс▒и: с▒гс▒ос▒▒с▒ос▒бс▒гс▒ос▒Юс▒Я
ЁЯЗ╗ЁЯЗм	с▒кс▒дс▒и, с▒кс▒дс▒и: с▒╡с▒╜с▒ис▒дс▒┤с▒дс▒е с▒гс▒Яс▒╣с▒ис▒бс▒дс▒▒ с▒Яс▒нс▒Юс▒ос▒╕с▒░
ЁЯЗ╗ЁЯЗо	с▒кс▒дс▒и, с▒кс▒дс▒и: с▒нс▒й с▒ос▒е с▒гс▒Яс▒╣с▒ис▒бс▒дс▒▒ с▒Яс▒нс▒Юс▒ос▒╕с▒░
ЁЯЗ╗ЁЯЗ│	с▒кс▒дс▒и, с▒кс▒дс▒и: с▒гс▒дс▒нс▒ос▒Ыс▒▒с▒Яс▒в
ЁЯЗ╗ЁЯЗ║	с▒кс▒дс▒и, с▒кс▒дс▒и: с▒╡с▒╖с▒Яс▒▒с▒йс▒Яс▒┤с▒й
ЁЯЗ╝ЁЯЗл	с▒кс▒дс▒и, с▒кс▒дс▒и: с▒гс▒Яс▒Юс▒дс▒е с▒Яс▒и с▒пс▒╖с▒йс▒┤с▒йс▒▒с▒Я
ЁЯЗ╝ЁЯЗ╕	с▒кс▒дс▒и, с▒кс▒дс▒и: с▒ес▒Яс▒вс▒Ъс▒гс▒Я
ЁЯЗ╜ЁЯЗ░	с▒кс▒дс▒и, с▒кс▒дс▒и: с▒ас▒Ъс▒ес▒Ъс▒гс▒Ъ
ЁЯЗ╛ЁЯЗк	с▒кс▒дс▒и, с▒кс▒дс▒и: с▒нс▒ос▒вс▒ос▒▒
ЁЯЗ╛ЁЯЗ╣	с▒кс▒дс▒и, с▒кс▒дс▒и: с▒вс▒Яс▒нс▒Ъс▒┤с▒о
ЁЯЗ┐ЁЯЗж	с▒кс▒дс▒и, с▒кс▒дс▒и: с▒ас▒Ъс▒зс▒о с▒Яс▒пс▒╖с▒ис▒дс▒ас▒Я
ЁЯЗ┐ЁЯЗ▓	с▒кс▒дс▒и, с▒кс▒дс▒и: с▒бс▒Яс▒вс▒╡с▒дс▒нс▒Я
ЁЯЗ┐ЁЯЗ╝	с▒кс▒дс▒и, с▒кс▒дс▒и: с▒бс▒дс▒вс▒╡с▒Яс▒гс▒о
┬д	с▒╡с▒Яс▒Эс▒йс▒ис▒йс▒в с▒ас▒Яс▒ис▒ос▒▒с▒ес▒д
